# 이전 전형|현재 전형 (자동 페어링에 사용)
서류|서류 합격
NCS|NCS 합격
필기|필기 합격
인적성 검사|인적성 합격
적성 검사|적성 검사 합격
인성 검사|인성 검사 합격
역량 검사|역량 검사 합격
AI 역량 검사|AI 역량 검사 합격
코딩 테스트|코딩 테스트 합격
과제|과제 합격
GSAT|GSAT 합격
SKCT|SKCT 합격
HMAT|HMAT 합격
LG Way Fit Test|LG Way Fit Test 합격
L-TAB|L-TAB 합격
CJ CAT|CJ CAT 합격
G-AT|G-AT 합격
PAT|PAT 합격
HATCH|HATCH 합격
1차 면접|1차 면접 합격
2차 면접|2차 면접 합격
3차 면접|3차 면접 합격
실무 면접|실무 면접 합격
기술 면접|기술 면접 합격
직무 면접|직무 면접 합격
임원 면접|임원 면접 합격
PT 면접|PT 면접 합격
토론 면접|토론 면접 합격
컬처핏 면접|컬처핏 면접 합격
부서장 면접|부서장 면접 합격
최종 면접|최종 합격
